10 10 3
1 1 1 1 1 1 1 1 1 1
1 0 0 0 0 0 0 0 0 1
1 0 0 0 0 0 0 0 0 1
1 3 4 2 0 0 5 0 0 1
1 0 2 4 0 0 5 0 0 1
1 6 0 0 0 5 6 0 0 1
1 0 2 4 0 0 0 5 0 1
1 0 0 0 0 6 0 0 0 1
1 0 0 0 0 5 0 0 0 1
1 1 1 1 1 1 1 1 1 1
